[MAIN MENU]
Training=Didacticiel
SingleMission=Missions uniques
Campaign=Campagnes
UnitReference=Infos unités
Options=Options
Credits=Crédits
Quit=Quitter

[GENERAL]
Back=Retour
Start=Commencer
Accept=Accepter
Random=Aléatoire
Help=Aide
Load=Charger
Save=Sauver
Delete=Effacer
No=NON
Yes=OUI
Labels=Textes
Menu=Menu
Hours=Heures

[BRIEFINGS]
InTheVicinityOf=Aux alentours de
DockedAtPort=Stationné à <PLAYERPORT>
StoresStatus=ENTIÈREMENT APPROVISIONNÉES
StoresStatusNeg=PLACE DISPONIBLE
SystemsStatus=TOUS SYSTÈMES OPÉRATIONNELS
SystemsStatusNeg=RÉPARATIONS NÉCÉSSAIRES
LeaveCombatNeg=AUCUN(E)
LeaveCombatMissionNeg=NON
LeaveCombatVessels=NAVIRES À PROXIMITÉ
LeaveCombatWeapons=ARMES À PROXIMITÉ
LeaveCombatAircraft=AÉRONEFS À PROXIMITÉ
LeaveCombatFlooding=INONDATION
LeaveCombatInsertion=ÉQUIPE FORCES SPECIALES <MISSIONSTATUS> DÉPLOYÉE
LeaveCombatLandStrike=FRAPPE TERRESTRE <MISSIONSTATUS> EFFECTUÉE <LANDSTRIKESTATUS>
NearDeploymentZone=La zone de déploiement de mission est proche.

//MissionWeaponsNeg=Nécéssite <NUMBER> <WEAPON> à bord pour cette mission.
//CommandoNeg=Nécéssite une équipe SEAL à bord pour cette mission.
RepairTime=Temps de réparation
Minutes=Min
Hours=Heures

[OTHER]
Posthumously=à titre posthume
NavyPrefixUSS=USS
SUBMARINE=sous-marin
WARSHIP=navire de guerre

[HEADINGS]
TrainingMissionHeader=DIDACTICIEL
SingleMissionHeader=MISSIONS UNIQUES
UnitReferenceHeader=INFOS UNITÉS
SelectVesselHeader=SÉLECTIONNER NAVIRE
BriefingHeader=BRIEFING
OrdersHeader=ORDRES
NewCampaignHeader=NOUVELLE CAMPAGNE
LoadCampaignHeader=CHARGER UNE CAMPAGNE
OptionsHeader=OPTIONS
IncomingMessageHeader=MESSAGE ENTRANT

[COMMANDS]
Battlestations=Tous les hommes aux postes de combat 
AttemptClosure=Approche à :
ContinueCourse=Continuer votre route
Loadout=Charg. Armes
DamageControl=Contrôle avaries
VesselStatus=XO: Rapport de statut
RearmRepair=Réarmer et réparer
ReviewOrders=Revoir les ordres
AbandonShip=Abandonner le navire
LeavePort=Larguer les amares, lever l'ancre !
HoursInPort=Heures dans le port :
ExitMission=Quitter le combat
QuitMission=Quitter la mission

[HUD]
ConditionsTab=CONDITIONS
SignatureTab=SIGNATURE
StoresTab=ARMEMENTS
DamageControlTab=CONTRÔLE AVARIES
Course=CAP
Speed=VIT
Depth=PRF
Rudder=GOU
Planes=BAR
Ballast=BAL
Bearing=AZI
Knot=KT
Feet=PI
Metre=M
Range=DIS
KiloYard=KYD
Kilometer=KM
Solution=SOL
Percentage=%
WeaponData=DONN ARM
RangeToEnable=DAA
TimeToRun=DDF
AmbientNoise=BRUIT AMBIENT
Decibels=dB
SurfaceDuct=CHENAL
Layer=COUCHE
Floor=PLANCHER À
Contact=CONTACT
Offline=HORS LIGNE
SignalStrength=PUIS SIGN
OwnShip=VÔTRE SM
SensorComparison=COMP CAP
Profile=PROFIL :
DepthGauge=0\n100\n200\n300\n400\n500\n600\n700\n800\n900\n1000
LoadWeapon=CHARGER
UnloadWeapon=DECHARGER
LoadCommando=EMBARQUER FORCES SPECIALES
UnloadCommando=DÉBARQUER FORCES SPECIALES
NoisemakerStores=LEURRES
NoContact=AUCUN CONTACT
VerticalLaunchSystem=Système de Lancement Vertical :
VerticalLaunchSystemAbb=SLV
HullStatus=Coque :
Left=gauche
Right=droite
TorpedoRoom=compartiment torpille
ControlRoom=Central Opérations
ReactorSpace=compartiment réacteur
EngineRoom=compartiment moteur
MachinerySpace=compartiment machines

SonarContact=Sierra
RadarContact=Romeo
VisualContact=Victor
ESMContact=Echo
MultipleContact=Master

SET SPEED=DÉFINIR VITESSE
HELM ORDERS=ORDRES TIMONIER
PLOT CSE=DÉFINIR CAP
SET DEPTH=DÉFINIR PLONGÉE
DIVE ORDERS=ORDRES PLONGÉE
E. BLOW=SURF. URG
MASTS=MÂTS
ACTIVE=ACTIF
DECOY=LEURRE
ESM=MSE
DETECTION THRESHOLD=SEUIL DE DÉTECTION
LLTV=LLTV
MARK=MARQUE
WIRE CONTROL=CONTRÔLE CÂBLE
GUIDANCE=GUIDAGE
MANUAL CTRL=CTRL MANUEL
LOAD WEAPON=CHARGER ARMES
LOAD SPEC OPS=EMBARQUER FS
WIRES=CÂBLES

[ACTION REPORT]
ActionReportSunk=COULÉ
ActionReportDamaged=ENDOMMAGÉ
ActionReportEscaped=ÉCHAPPÉ
ActionReportUndetected=NON DÉTECTÉ
ActionReportNone=AUNCUN
ActionReportLost=PERDU
ActionReportLostAllHands=PERDU AVEC TOUT SON ÉQUIPAGE
ActionReportHowSunk=COULÉ PAR:
ActionReportImplosion=IMPLOSION
ActionReportCollision=COLLISION
ActionReportScuttled=SABORDAGE

[CAMPAIGN]
SaveFileName=Nom sauvegarde :
CommanderName=Nom du commandant :
DeleteSaveFile=Supprimer fichier : <FILENAME>?
SaveExists=Fichier déja existant, écraser ?
Statistics=Résumé
OpenBriefing=Brief

[UNIT REFERENCE]
ReferenceDimensions=Dimensions
ReferenceTons=tonnes
ReferenceMetre=m
ReferenceKnot=kn
ReferenceFeet=pi
ReferenceCrew=Équipage
ReferenceDefensive=Armes Défensives
Reference30mmCIWS=Canons anti-missiles
ReferenceNone=Aucun(e)
ReferenceOffensive=Armes Offensives
ReferenceMissiles=Missiles
ReferenceDecoys=Leurres
ReferenceTorpedoes=Torpilles
ReferenceSensors=Capteurs
ReferenceNavRADAR=Radar de navigation seulement
ReferenceSearchRADAR=Radar de recherche, MSE
ReferenceMastMounted=monté sur mât
ReferenceSonarBoth=sonar actif et passif
ReferenceSonarActive=sonar actif
ReferenceSonarPassive=sonar passif
ReferenceSonar=Sonar
ReferenceRadar=Radar
ReferenceActive=Actif
ReferencePassive=Passif
ReferenceTowed=Remorqué
ReferenceHullMounted=monté sur coque
ReferenceTowedArray=sonar remorqué
ReferenceDipping=immergé
ReferenceSonobuoys=Bouées sonar
ReferenceAircraft=Aéronef
ReferenceNotes=Notes
ReferenceKilogram=kg
ReferenceYard=yd
ReferenceRange=Distance
ReferenceMaxSpeed=Vitesse max
ReferenceSeekerRange=Portée de recherche
ReferenceAt=à
FrequencyVeryLow=très faible
FrequencyLow=faible
FrequencyMedium=moyenne
FrequencyHigh=haute
Frequency=fréquence
Frequencies=fréquences
ReferenceVeryQuiet=Très silencieux
ReferenceSemiQuiet=Semi-silencieux
ReferenceQuiet=silencieux
ReferenceSemiNoisy=Semi-bruyant
ReferenceNoisy=Bruyant
ReferenceVeryNoisy=Très Bruyant
FrequencyAbbreviated=F
FrequencyAbbreviatedVL=TB
FrequencyAbbreviatedL=B
FrequencyAbbreviatedM=M
FrequencyAbbreviatedH=H
ReferenceTestDepth=Profondeur d'essai :
ReferenceWires=Nombre de câbles :

[Sea States]
Calm=Calme
LightAir=Très légère Brise
LightBreeze=Légère Brise
GentleBreeze=Petite Brise
ModerateBreeze=Jolie Brise
FreshBreeze=Bonne Brise
StrongBreeze=Vent Frais
HighWind=Grand Frais

[Weather]
Clear=Clair
Scattered=Epars
Broken=Morcelés
Overcast=Couvert
Rain=Pluie
Storm=Tempête
Snow=Neige
SnowStorm=Tempête de neige

[Strength Types]
ZeroStrength=Aucune
VeryWeak=très faible
Weak=faible
Moderate=Modéré
Strong=Fort
VeryStrong=Très fort

[ERROR]
FatalError=ERREUR FATALE :

[OPTIONS]
GameSettings=Jeu
Controls=Contrôles
VideoSettings=Vidéo
AudioSettings=Audio
DefaultControls=Restaurer les contrôles par défaut
DefaultCommanderName=Nom du commandant par défaut :
Difficulty=Difficulté
Easy=Facile
Normal=Casual
Hard=Réaliste
Elite=Élite
WorldScale=Échelle des distances
Scale1=1:1
Scale2=1:2
Scale3=1:3
Scale4=1:4
SpeedMultiplier=Multiplicat. Vitesse
HideUnclassified=Masq. faible SOL. Contacts en 3D 
Tooltips=Info-bulles

HUDSize=Taille ATH
AutoSave=Sauvegarde auto
DisableIronman=Désactiver le mode Ironman
PlayerMarker=Marqueur du joueur
NonMetricUnits=Unités non mètriques
EventCamera=Caméra évenement
InvertMouse=Inverser la souris
FullScreen=Plein écran
Resolution=Résolution
Shadows=Ombres
VSync=Synchro verticale
DetailedOcean=Océan détaillé
Terrain=Terrain
Trees=Arbres
UnderwaterParticles=Particules sous-marines
AntiAliasing=Anticrénelage
Off=Désactivé
2x=2x
4x=4x
8x=8x
OceanQuality=Qualité de l'océan
High=Élevé
Medium=Moyenne
Low=Basse
ColorFilter=Filtre de couleur
AmbientOcclusion=Occlusion ambiante
Bloom=Flou lumineux
WorldObjects=Afficher les objets du monde
MusicInCombat=Musique en combat
Volume=Volume
Music=Musique
CrewVoice=Voix équipage
CameraSensitivity=Sensibilité caméra
Apply=Appliquer

[HELP]
HelpGeneral=Général
HelpReference=Référence
HelpWeapons=Armement
HelpNavigation=Navigation
HelpMap=Carte
HelpSensors=Capteurs
HelpTactics=Tactiques
HelpDamage=Dommage
HelpCampaign=Campagne
LeftMouse=CLIC GAUCHE
RightMouse=CLIC DROIT
MiddleMouse=BOUTON CENTRAL SOURIS
MouseWheel=MOLETTE SOURIS
ShiftKey=Maj 
ControlKey=Ctrl 
AltKey=Alt 


[KEYBIND DISPLAY NAMES: COMMAND=OPTIONS DISPLAYNAME]
Help=Aide

Rudder Left=Gouvernail gauche
Rudder Right=Gouvernail droite
Set Course=Définir cap
Planes Up=Barres de plongés Haut
Planes Down=Barres de plongés Bas
Ballast Up=Chasse normal ballast
Ballast Down=Remplir ballast
Increase Power=Augmenter la puissance
Decrease Power=Diminuer la puissance

Level Submarine=Palier
Periscope Depth=Immersion périscopique 
Blow Ballast=Chasse rapide au Ballast
Emergency Deep=Plongée d'urgence
Sonar Mode=Sonar actif
Silent Running=Situation silence 
Noisemaker=Leurre acoustique

ESM Mast=Mât MSE
RADAR Mast=Mât Radar
Periscope=Périscope
Periscope View=Vue Périscope
Night Vision=Vision nocturne
Mark Target=Marquer cible

Tactical Map=Carte Tactique
Centre Map=Centrer la carte
Auto Centre Map=Centrage auto carte

Conditions=Conditions
Signature=Signature
Damage Report=Contrôle avaries
Context Menu Previous=Précédent
Context Menu Next=Suivant
Context Menu Set=Sélectionner
Next Contact=Contact suivant
Recognition Manual=Manuel d'identification
Helm Controls=Contrôles gouvernail
Dive Controls=Contrôles plongée
Sensor Controls=Contrôles capteur
Expand Log=Développer le journal

Next Tube=Tube suivant
Load Tube=Charger le tube
Stores=Armements
Fire Tube=Mise à feu
Set Waypoint=Définir point de passage
Edit Waypoint=Éditer point de passage

Weapon Homing=Guidage arme
Weapon Attack=Recherche arme
Weapon Depth=Profondeur arme
Activate Torpedo=Activer Torpille
Cut Wire=Couper le câble
Steer Torpedo Left=Direction Torpille gauche
Steer Torpedo Right=Direction Torpille droite
Steer Torpedo Shallow=Direction Torpille surface
Steer Torpedo Deep=Direction Torpille profondeur

Time Compression=Compression du temps
Hide HUD=Masquer ATH
Event Camera=Caméra évènements Oui/Non

Zoom In=Zoomer
Zoom Out=Dézoomer

Camera Left=Caméra gauche
Camera Right=Caméra droite
Camera Up=Caméra haut
Camera Down=Caméra bas
Camera To Player=Caméra sur le joueur
Camera To Selected Contact=Caméra sur contact sélectionné
Camera To Weapon=Caméra sur les armes
Camera To Aircraft=Caméra sur l'aviation
Camera To Scenery=Caméra sur le paysage
Drag Camera=Faire glisser la Caméra
Still Camera=Figer la caméra

Patrol Speed=Vitesse de patrouille
Flank Speed=Vitesse maximum
Briefing=Briefing

Museum Next=Musée Suivant
Museum Previous=Musée Précédent

Continue=Continuer
Cancel or Quit=Annuler ou Quitter